%%%%%%%%%%%%%%%%
................
...##......##...
....#......#....
.@..#......#..&.
....#......#....
...##......##...
................
%%%%%%%%%%%%%%%%
